13 7
0 X 0 0 0 7 0 
0 7 X 0 0 2 0 
0 0 P 0 0 0 0 
0 0 0 0 3 0 4 
5 0 0 4 0 8 X 
0 5 0 X 3 3 0 
5 0 8 0 0 6 5 
X 0 0 X X 0 8 
2 7 6 2 4 6 0 
0 8 0 0 0 0 0 
0 6 0 3 0 0 5 
0 0 0 8 5 5 X 
0 8 0 X 0 0 4 